1111111111111111111
1000000000000000001
10000C00000000E0001
1000000000000000001
10000P000000000C001
1000000000100000001
1000100000000000001
1000000000000000001
1111111111111111111
