1111111111111111111
1000000000110000011
101110C011000011001
1000100011110000001
100010P000001101101
100010011000C000001
1000100000110110001
100011100E000000011
1111111111111111111
