1111111111111111111
1000000000000000C11
101110C011000011001
1000100011100000001
1C0011P000001111111
1000111011110110001
100011100E001001111
1111111111111111111
