1111111111111111111
1000000000000000001
10000000000000E0001
100000000C000000001
1000000000000000001
10000P0000100000001
1000100000000000001
1000000000000000001
1111111111111111111
