1111111111111111111
1000000000010000C11
101110C011000011001
1000100011100000001
1C0010P110001111111
1000110011110110001
100011100E001001111
1111111111111111111
