1111111111111111111
1000000000000000011
10000001000000E0001
1000001111111111101
1111111P00000000001
1000000111111111101
1000100C00000000001
10000000C0000000101
1111111111111111111
