1111111111111111111
1000000000000000001
10000000E0000000001
1000000001000000001
1000000000000000001
1000000000000000001
100000000000000C001
10000P0000100000001
1000100000000000001
1000000000000000001
1111111111111111111
